D19.arff	weka.classifiers.trees.RandomForest
D39.arff	weka.classifiers.trees.J48
D73.arff	weka.classifiers.meta.AdaBoostM1
lung-cancer.arff	weka.classifiers.trees.LMT
mbagrade.arff	weka.classifiers.lazy.IBk
molecular-biology_promoters.arff	weka.classifiers.meta.LogitBoost
monks-problems-1_test.arff	weka.classifiers.meta.RandomSubSpace
monks-problems-1_train.arff	weka.classifiers.functions.MultilayerPerceptron
monks-problems-2_test.arff	weka.classifiers.functions.MultilayerPerceptron
monks-problems-2_train.arff	weka.classifiers.functions.MultilayerPerceptron
monks-problems-3_test.arff	weka.classifiers.meta.MultiClassClassifier
monks-problems-3_train.arff	weka.classifiers.meta.ClassificationViaRegression
schlvote.arff	weka.classifiers.meta.ClassificationViaRegression
solar-flare_1.arff	weka.classifiers.meta.ClassificationViaRegression
solar-flare_2.arff	weka.classifiers.meta.RandomSubSpace
T17.arff	weka.classifiers.trees.RandomForest
T20.arff	weka.classifiers.trees.LMT
T21.arff	weka.classifiers.trees.RandomForest
anneal.arff	weka.classifiers.meta.RandomCommittee
anneal.ORIG.arff	weka.classifiers.meta.LogitBoost
arrhythmia.arff	weka.classifiers.trees.LMT
audiology.arff	weka.classifiers.functions.MultilayerPerceptron
australian.arff	weka.classifiers.rules.DecisionTable
autos.arff	weka.classifiers.trees.RandomForest
balance-scale.arff	weka.classifiers.functions.MultilayerPerceptron
bank.arff	weka.classifiers.meta.Bagging
breast-cancer.arff	weka.classifiers.lazy.LWL
breast-w.arff	weka.classifiers.meta.ClassificationViaRegression
bridges_version1.arff	weka.classifiers.bayes.NaiveBayes
bridges_version2.arff	weka.classifiers.bayes.NaiveBayes
car.arff	weka.classifiers.functions.MultilayerPerceptron
cmc.arff	weka.classifiers.meta.AttributeSelectedClassifier
colic.arff	weka.classifiers.trees.RandomForest
contact-lenses.arff	weka.classifiers.functions.Logistic
credit-a.arff	weka.classifiers.lazy.LWL
credit-g.arff	weka.classifiers.trees.RandomForest
cylinder-bands.arff	weka.classifiers.trees.LMT
D103.arff	weka.classifiers.meta.MultiClassClassifier
D15.arff	weka.classifiers.lazy.KStar
D16.arff	weka.classifiers.trees.RandomForest
D20.arff	weka.classifiers.functions.MultilayerPerceptron
D21.arff	weka.classifiers.functions.MultilayerPerceptron
D24.arff	weka.classifiers.trees.RandomTree
D36.arff	weka.classifiers.trees.RandomForest
D37.arff	weka.classifiers.meta.LogitBoost
D41.arff	weka.classifiers.trees.RandomForest
D74.arff	weka.classifiers.meta.RandomCommittee
D75.arff	weka.classifiers.meta.Vote
D98.arff	weka.classifiers.meta.ClassificationViaRegression
dermatology.arff	weka.classifiers.bayes.BayesNet
diabetes.arff	weka.classifiers.meta.ClassificationViaRegression
ecoli.arff	weka.classifiers.trees.RandomForest
eucalyptus.arff	weka.classifiers.rules.DecisionTable
eye_movements.arff	weka.classifiers.trees.RandomForest
glass.arff	weka.classifiers.trees.RandomForest
grub-damage.arff	weka.classifiers.bayes.NaiveBayes
heart-c.arff	weka.classifiers.meta.AdaBoostM1
heart-h.arff	weka.classifiers.lazy.LWL
heart-statlog.arff	weka.classifiers.trees.LMT
hepatitis.arff	weka.classifiers.lazy.KStar
hypothyroid.arff	weka.classifiers.meta.LogitBoost
ionosphere.arff	weka.classifiers.meta.RandomCommittee
iris.2D.arff	weka.classifiers.functions.Logistic
iris.arff	weka.classifiers.functions.MultilayerPerceptron
kr-vs-kp.arff	weka.classifiers.trees.LMT
labor.arff	weka.classifiers.functions.MultilayerPerceptron
landsat_test.arff	weka.classifiers.trees.RandomForest
landsat_train.arff	weka.classifiers.trees.RandomForest
letter.arff	weka.classifiers.trees.RandomForest
liver-disorders.arff	weka.classifiers.trees.RandomForest
lymph.arff	weka.classifiers.lazy.KStar
mfeat-factors.arff	weka.classifiers.functions.SMO
mfeat-fourier.arff	weka.classifiers.trees.RandomForest
mfeat-karhunen.arff	weka.classifiers.functions.SMO
mfeat-morphological.arff	weka.classifiers.trees.LMT
nursery.arff	weka.classifiers.meta.ClassificationViaRegression
optdigits.arff	weka.classifiers.functions.MultilayerPerceptron
page-blocks.arff	weka.classifiers.trees.RandomForest
pasture.arff	weka.classifiers.bayes.BayesNet
pendigits.arff	weka.classifiers.trees.RandomForest
postoperative-patient-data.arff	weka.classifiers.meta.Vote
segment-challenge.arff	weka.classifiers.trees.RandomForest
segment-test.arff	weka.classifiers.trees.RandomForest
segment.arff	weka.classifiers.trees.RandomForest
sick.arff	weka.classifiers.trees.LMT
sonar.arff	weka.classifiers.functions.MultilayerPerceptron
soybean.arff	weka.classifiers.trees.LMT
spambase.arff	weka.classifiers.trees.RandomForest
spectf_test.arff	weka.classifiers.meta.LogitBoost
squash-stored.arff	weka.classifiers.rules.JRip
squash-unstored.arff	weka.classifiers.meta.LogitBoost
T1.arff	weka.classifiers.lazy.IBk
T10.arff	weka.classifiers.meta.ClassificationViaRegression
T12.arff	weka.classifiers.meta.RandomSubSpace
T13.arff	weka.classifiers.functions.MultilayerPerceptron
T14.arff	weka.classifiers.rules.DecisionTable
T15.arff	weka.classifiers.meta.ClassificationViaRegression
T16.arff	weka.classifiers.meta.MultiClassClassifier
T18.arff	weka.classifiers.meta.ClassificationViaRegression
T19.arff	weka.classifiers.meta.MultiClassClassifier
T22.arff	weka.classifiers.meta.LogitBoost
T23.arff	weka.classifiers.meta.MultiClassClassifier
weather.nominal.arff	weka.classifiers.trees.RandomForest
weather.numeric.arff	weka.classifiers.trees.RandomForest
white-clover.arff	weka.classifiers.meta.RandomCommittee
wine.arff	weka.classifiers.meta.MultiClassClassifier
zoo.arff	weka.classifiers.lazy.KStar
unbalanced.arff	weka.classifiers.trees.LMT
vehicle.arff	weka.classifiers.trees.LMT
vote.arff	weka.classifiers.functions.MultilayerPerceptron
vowel.arff	weka.classifiers.lazy.KStar
waveform-5000.arff	weka.classifiers.meta.MultiClassClassifier
